5555555555555555555555555555
5111111111111551111111111115
5155551555551551555551555515
5850051500051551500051500585
5155551555551551555551555515
5111111111111111111111111115
5155551551555555551551555515
5155551551555555551551555515
5111111551111551111551111115
5555551555550550555551555555
0000051555550550555551500000
0000051550000000000551500000
0000051550555DD5550551500000
55555515505P0000C50551555555
0000001000500000050001000000
55555515505B0000I50551555555
0000051550555555550551500000
0000051550000000000551500000
0000051550555555550551500000
5555551550555555550551555555
5111111111111551111111111115
5155551555551551555551555515
5155551555551551555551555515
5811551111111001111111551185
5551551551555555551551551555
5551551551555555551551551555
5111111551111551111551111115
5155555555551551555555555515
5155555555551551555555555515
5111111111111111111111111115
5555555555555555555555555555
